111111111111111
111110C000000E1
111110111111101
11110C010111101
1110C0011111101
11C000011111101
110P000000000C1
111111111111111