111111111111111111111111
100E11111111111111110111
1C1011111111111111110111
1P0011111111111111110111
111111111111111111111111