11111111
10C000E1
1010C111
1P001001
11111111