1111111111
100C000001
1011101001
11110C0101
1000C00111
1000000111
100P0000E1
1111111111